actor	actor
empleado	empleado
cereal	cereal
pimienta	pimienta
error	error
risa	risa
piano	piano
banco	banco
origen	origen
seguridad	seguridad
dentista	dentista
cirujano	cirujano
accidente	accidente
sótano	sotano
destrucción	destruccion
mejora	mejora
fruta	fruta
caramelo	caramelo
Desierto	Desierto
jungla	jungla
descuento	descuento
vendedor	vendedor
sugerencia	sugerencia
suposición	suposicion
instrucción	instruccion
medición	medicion
inspector	inspector
médico	medico
tractor	tractor
guardería	guarderia
insecto	insecto
patata	patata
talento	talento
arma	arma
Academia	Academia
lectura	lectura
fantasía	fantasia
vacaciones	vacaciones
cámara	camara
escalera	escalera
autor	autor
lector	lector
turista	turista
emperador	emperador
restaurante	restaurante
empresa	empresa
guitarra	guitarra
espejo	espejo
maíz	maiz
carne	carne
pez	pez
pájaro	pajaro
mantequilla	mantequilla
vela	vela
cerveza	cerveza
comida	comida
rodilla	rodilla
hueso	hueso
fingir	fingir
lengua	lengua
revista	revista
taller	taller
vecino	vecino
empleado	empleado
asunto	asunto
injuria	injuria
finalizando	finalizando
pantalla	pantalla
compromiso	compromiso
compromiso	compromiso
carpeta	carpeta
bomba	bomba
salsa	salsa
atual	atual
almas	almas
aguacate 	aguacate 
balcón	balcon
carne	carne
blando	blando
blando	blando
candor	candor
cargo	cargo
comodidad	comodidad
comprensivo	comprensivo
construir	construir
doce	doce
invitar	invitar
éxito	exito
fábrica	fabrica
fila	fila
gripe	gripe
excitado	excitado
débil	debil
intención	intencion
aire	aire
adulto	adulto
agenda	agenda
agente	agente
alarma	alarma
alcohol	alcohol
altar	altar
área	area
artista	artista
atmósfera	atmosfera
atención 	atencion 
banana	banana
base	base
blusa	blusa
cabina	cabina
cable	cable
café	cafe
cafetería	cafeteria
canal	canal
cáncer	cancer
capital	capital
carbón	carbon
centro	centro
cheque	cheque
chocolate	chocolate
clase	clase
club	club
costa	costa
color	color
combustión	combustion
compañía 	compania 
concierto	concierto
conclusión	conclusion
conductor	conductor
confusión	confusion
construcción 	construccion 
continente	continente
control	control
crisis	crisis
cultura	cultura
debate	debate
decisión	decision
dimensión	dimension
dirección	direccion
director 	director 
desastre	desastre
disco	disco
distancia	distancia
división 	division 
doctor	doctor
dragón	dragon
drama	drama
editorial	editorial
elefante	elefante
enigma	enigma
excursión	excursion
explosión	explosion
expulsión	expulsion
extensión	extension
exterior	exterior
factor	factor
familia	familia
festival	festival
final	final
formula	formula
funeral	funeral
galaxia	galaxia
general 	general 
génesis	genesis
múltiple	multiple
música	musica
musical	musical
nostalgia	nostalgia
objeto	objeto
observatorio	observatorio
ocasión	ocasion
océano	oceano
ópera	opera
oportunidad	oportunidad
original	original
palacio	palacio
pánico	panico
panorama	panorama
paraíso	paraiso
parque	parque
parte	parte
pastor	pastor
paciencia	paciencia
patio	patio
perfume	perfume
foto	foto
planeta	planeta
planes	planes
plantas	plantas
plaza	plaza
pretensión	pretension
propaganda	propaganda
protector	protector
radical	radical
radio	radio
rancho	rancho
realidad	realidad
región	region
religión	religion
reunión	reunion
revisión	revision
ritual	ritual
sabor	sabor
salario	salario
serie	serie
sofá	sofa
subversión	subversion
sugestão	sugestao
taxi	taxi
televisión	television
terror	terror
total	total
tránsito	transito
uniforme	uniforme
unión	union
universo	universo
universidad	universidad
vegetales	vegetales
velocidad	velocidad
versión	version
violín	violin
advertencia	advertencia
danza	danza
jugo	jugo
jarra	jarra
vial	vial
sobre	sobre
leopardo	leopardo
hipopótamo	hipopotamo
grupo	grupo
problema	problema
humano	humano
información	informacion
momento	momento
lista	lista
aire	aire
mortal	mortal
exámenes	examenes
computadora	computadora
apartamento	apartamento
animales	animales
actor	actor
movimientos	movimientos
metabolismo	metabolismo
equipo	equipo
departamento	departamento
cocodrilo	cocodrilo
calendario	calendario
auditorio	auditorio
actvidades	actvidades
acceso	acceso
académico	academico
lenguaje	lenguaje
electricidad	electricidad
efecto	efecto
disertación	disertacion
diccionario	diccionario
competición	competicion
música	musica
memoria	memoria
parte	parte
humano	humano
línea	linea
local	local
historia	historia
millón	millon
idea	idea
material	material
hora	hora
hotel	hotel
manera	manera
radio	radio
hospital	hospital
gas	gas
parque	parque
universo	universo
independencia	independencia
metal	metal
ideal	ideal
motor	motor
minuto	minuto
inteligencia	inteligencia
indentificación	indentificacion
restaurante	restaurante
piano	piano
magico	magico
error	error
fruta	fruta
lección	leccion
mate	mate
inspección	inspeccion
limón	limon
horror	horror
invasión	invasion
turista	turista
mapa	mapa
inspector	inspector
manía	mania
manual	manual
menú	menu
expulsión	expulsion
maestro	maestro
patio	patio
helicóptero	helicoptero
melón	melon
accidente	accidente
adulto	adulto
sociedad	sociedad
control	control
colores	colores
diente	diente
asumir	asumir
pull	pull
collar	collar
arma	arma
eventualmente	eventualmente
largo	largo
rima	rima
resumir	resumir
sensual	sensual
amasar	amasar
pretender	pretender
soporte	soporte
récord	record
asistir	asistir
resumen	resumen
pariente	pariente
leyenda	leyenda
mayor	mayor
librería	libreria
comentar	comentar
complete	complete
diversión	diversion
imagina	imagina
consulta	consulta
amplificar	amplificar
simplificar	simplificar
celebrar	celebrar
problema	problema
divertir	divertir
posible	posible
dependiente	dependiente
curso	curso
motivado	motivado
diario	diario
asociado	asociado
costumbre	costumbre
académico	academico
convicto	convicto
contestar	contestar
confidente	confidente
sensibilidad	sensibilidad
sistema	sistema
colegio	colegio
universidad	universidad
campo	campo
pacífico	pacifico
bondad	bondad
avalado	avalado
responsable	responsable
atender	atender
básico	basico
vehículo	vehiculo
red	red
letra	letra
antena	antena
escolar	escolar
retirado	retirado
novela	novela
medicina	medicina
lancha	lancha
neto	neto
droga	droga
junco	junco
policía	policia
noticia	noticia
pasta	pasta
maula	maula
dogma	dogma
prejuicio	prejuicio
oficio	oficio
flanco	flanco
flanco	flanco
trazar	trazar
inhabitado	inhabitado
jornal	jornal
exquisito	exquisito
puso	puso
lectura	lectura
fila	fila
