actor	actor
clerk	empleado
cereal	cereal
pepper	pimienta
error	error
laugh	risa
piano	piano
bench	banco
origin	origen
security	seguridad
dentist	dentista
surgeon	cirujano
accident	accidente
destruction	destruccion
improvement	mejora
fruit	fruta
candy	caramelo
desert	Desierto
jungle	jungla
discount	descuento
salesman	vendedor
suggestion	sugerencia
assumption	suposicion
instruction	instruccion
measurement	medicion
inspector	inspector
physician	medico
tractor	tractor
insect	insecto
potato	patata
talent	talento
academy	Academia
lecture	lectura
fantasy	fantasia
camera	camara
author	autor
tourist	turista
emperor	emperador
restaurant	restaurante
enterprise	empreendimento
guitar	guitarra
finger	fingir
carpet	carpeta
bomb	bomba
salsa	salsa
actual	actual
alms	almas
avocado	aguacate 
balcony	balcon
beef	carne
brand	blando
bland	blando
candor	candor
cargo	cargo
commodity	comodidad
comprehensive	comprensivo
construe	construir
doze	doce
invite	invitar
exit	exito
fabric	fabrica
file	fila
grip	gripe
excited	excitado
devil	debil
intent	intencion
air	aire
adult	adulto
agenda	agenda
agent	agente
alarm	alarma
alcohol	alcohol
altar	altar
area	area
artist	artista
atmosphere	atmosfera
attention	atencion 
banana	banana
base	base
blouse	blusa
cabin	cabina
cable	cable
cafe	cafe
cafeteria	cafeteria
canal	canal
cancer	cancer
capital	capital
carbon	carbon
center	centro
cheque	cheque
chocolate	chocolate
class	clase
club	club
coast	costa
color	color
combustion	combustion
company	compania 
concert	concierto
conclusion	conclusion
conductor	conductor
confusion	confusion
construction	construccion 
continent	continente
control	control
crisis	crisis
culture	cultura
debate	debate
decision	decision
dimension	dimension
direction	direccion
director	director 
disaster	desastre
disco	disco
distance	distancia
division	division 
doctor	doctor
dragon	dragon
drama	drama
editorial	editorial
elephant	elefante
enigma	enigma
excursion	excursion
explosion	explosion
expulsion	expulsion
extension	extension
exterior	exterior
factor	factor
family	familia
festival	festival
final	final
formula	formula
funeral	funeral
galaxy	galaxia
general	general 
genesis	genesis
multiple	multiple
music	musica
musical	musical
nostalgia	nostalgia
object	objeto
observatory	observatorio
occasion	ocasion
ocean	oceano
opera	opera
opportunity	oportunidad
original	original
palace	palacio
panic	panico
panorama	panorama
paradise	paraiso
park	parque
part	parte
pastor	pastor
patience	paciencia
patio	patio
perfume	perfume
photo	foto
planet	planeta
plans	planes
plants	plantas
plaza	plaza
pretension	pretension
propaganda	propaganda
protector	protector
radical	radical
radio	radio
ranch	rancho
reality	realidad
region	region
religion	religion
reunion	reunion
revision	revision
ritual	ritual
savor	sabor
salary	salario
series	serie
sofa	sofa
subversion	subversion
taxi	taxi
television	television
terror	terror
total	total
transit	transito
uniform	uniforme
union	union
universe	universo
university	universidad
vegetables	vegetales
velocity	velocidad
version	version
violin	violin
advertising	advertencia
jug	jugo
jar	jarra
vial	vial
leopard	leopardo
hippopotamus	hipopotamo
group	grupo
problem	problema
human	humano
information	informacion
moment	momento
list	lista
mortal	mortal
exams	examenes
computer	computadora
apartment	apartamento
animals	animales
movements	movimientos
metabolism	metabolismo
equipment	equipo
department	departamento
crocodile	cocodrilo
calendar	calendario
auditorium	auditorio
access	acceso
academic	academico
language	lenguaje
electricity	electricidad
effects	efecto
dissertation	disertacion
dictionary	diccionario
competition	competicion
memory	memoria
line	linea
local	local
history	historia
million	millon
idea	idea
material	material
hour	hora
hotel	hotel
manner	manera
hospital	hospital
gas	gas
independence	independencia
metal	metal
ideal	ideal
motor	motor
minute	minuto
intelligence	inteligencia
identification	indentificacion
magic	magico
lesson	leccion
mate	mate
inspection	inspeccion
lemon	limon
horror	horror
invasion	invasion
map	mapa
mania	mania
manual	manual
menu	menu
helicopter	helicoptero
melon	melon
society	sociedad
dent	diente
assume	asumir
pull	pull
army	arma
eventually	eventualmente
large	largo
resume	resumir
sensual	sensual
amass	amasar
pretend	pretender
support	soporte
record	record
assist	asistir
parents	pariente
legend	leyenda
mayor	mayor
library	libreria
comment	comentar
complete	complete
diversion	diversion
imagine	imagina
consult	consulta
amplify	amplificar
simplify	simplificar
celebrate	celebrar
divert	divertir
possible	posible
dependable	dependiente
curse	curso
motivated	motivado
dairy	diario
associated	asociado
costume	costumbre
convict	convicto
contest	contestar
confident	confidente
sensibility	sensibilidad
system	sistema
college	colegio
camp	campo
pacific	pacifico
bond	bondad
available	avalado
responsible	responsable
attend	atender
basic	basico
vehicle	vehiculo
red	red
letter	letra
anthem	antena
scholar	escolar
retired	retirado
novel	novela
medicine	medicina
lunch	lancha
net	neto
drug	droga
junk	junco
policy	policia
notice	noticia
pasta	pasta
maul	maula
dogma	dogma
prejudice	prejuicio
office	oficio
flank	flanco
trace	trazar
inhabitable	inhabitado
journal	jornal
exquisite	exquisito
push	puso
fill	fila
condiment	condimiento
augment	aumentar
brink	brinco
cup	copa
project	proyecto
embarrassed	embarazada
preference	preferencia
date	dato
gaffe	gafa
gracious	gracioso
panel	panel
priority	prioridad
integral	integral
vital	vital
fatal	fatal
card	carton
vista	vista
scenario	escenario
