actor	actor
empleado	clerk
cereal	cereal
pimienta	pepper
error	error
risa	laugh
piano	piano
banco	bench
origen	origin
seguridad	security
dentista	dentist
cirujano	surgeon
accidente	accident
destruccion	destruction
mejora	improvement
fruta	fruit
caramelo	candy
desierto	desert
jungla	jungle
descuento	discount
vendedor	salesman
sugerencia	suggestion
suposicion	assumption
instruccion	instruction
medicion	measurement
inspector	inspector
medico	physician
tractor	tractor
insecto	insect
patata	potato
talento	talent
academia	academy
lectura	lecture
fantasia	fantasy
camara	camera
autor	author
turista	tourist
emperador	emperor
restaurante	restaurant
emprendedor	entrepreneur
guitarra	guitar
fingir	finger
carpeta	carpet
bomba	bomb
salsa	salsa
actual	actual
almas	alms
aguacate 	avocado
balcon	balcony
carne	beef
blando	brand
blando	bland
candor	candor
cargo	cargo
comodidad	commodity
comprensivo	comprehensive
construir	construe
doce	doze
invitar	invite
exito	exit
fabrica	fabric
fila	file
gripe	grip
excitado	excited
debil	devil
intencion	intent
aire	air
adulto	adult
agenda	agenda
agente	agent
alarma	alarm
alcohol	alcohol
altar	altar
area	area
artista	artist
atmosfera	atmosphere
atencion	attention
banana	banana
base	base
blusa	blouse
cabina	cabin
cable	cable
cafe	cafe
cafeteria	cafeteria
canal	canal
cancer	cancer
capital	capital
carbon	carbon
centro	center
cheque	cheque
chocolate	chocolate
clase	class
club	club
costa	coast
color	color
combustion	combustion
compania	company
concierto	concert
conclusion	conclusion
conductor	conductor
confusion	confusion
construccion	construction
continente	continent
control	control
crisis	crisis
cultura	culture
debate	debate
decision	decision
dimension	dimension
direccion	direction
director	director
desastre	disaster
disco	disco
distancia	distance
division	division
doctor	doctor
dragon	dragon
drama	drama
editorial	editorial
elefante	elephant
enigma	enigma
excursion	excursion
explosion	explosion
expulsion	expulsion
extension	extension
exterior	exterior
factor	factor
familia	family
festival	festival
final	final
formula	formula
funeral	funeral
galaxia	galaxy
general	general
genesis	genesis
multiple	multiple
musica	music
musical	musical
nostalgia	nostalgia
objeto	object
observatorio	observatory
ocasion	occasion
oceano	ocean
opera	opera
oportunidad	opportunity
original	original
palacio	palace
panico	panic
panorama	panorama
paraiso	paradise
parque	park
parte	part
pastor	pastor
paciencia	patience
patio	patio
perfume	perfume
foto	photo
planeta	planet
plan	plan
planta	plant
plaza	plaza
pretension	pretension
propaganda	propaganda
protector	protector
radical	radical
radio	radio
rancho	ranch
realidad	reality
region	region
religion	religion
reunion	reunion
revision	revision
ritual	ritual
sabor	savor
salario	salary
serie	series
sofa	sofa
subversion	subversion
taxi	taxi
television	television
terror	terror
total	total
transito	transit
uniforme	uniform
union	union
universo	universe
universidad	university
vegetal	vegetable
velocidad	velocity
version	version
violin	violin
advertencia	advertising
jugo	jug
jarra	jar
vial	vial
leopardo	leopard
hipopotamo	hippopotamus
grupo	group
problema	problem
humano	human
informacion	information
momento	moment
lista	list
mortal	mortal
examen	exam
computadora	computer
apartamento	apartment
animal	animal
movimiento	movement
metabolismo	metabolism
equipo	equipment
departamento	department
cocodrilo	crocodile
calendario	calendar
auditorio	auditorium
acceso	access
academico	academic
lenguaje	language
electricidad	electricity
efecto	effects
disertacion	dissertation
diccionario	dictionary
competicion	competition
memoria	memory
linea	line
local	local
historia	history
millon	million
idea	idea
material	material
hora	hour
hotel	hotel
manera	manner
hospital	hospital
gas	gas
independencia	independence
metal	metal
ideal	ideal
motor	motor
minuto	minute
inteligencia	intelligence
identificacion	identification
magico	magic
leccion	lesson
mate	mate
inspeccion	inspection
limon	lemon
horror	horror
invasion	invasion
mapa	map
mania	mania
manual	manual
menu	menu
helicoptero	helicopter
melon	melon
sociedad	society
diente	dent
asumir	assume
pull	pull
arma	army
eventualmente	eventually
largo	large
resumir	resume
sensual	sensual
amasar	amass
pretender	pretend
soporte	support
record	record
asistir	assist
pariente	parents
leyenda	legend
mayor	mayor
libreria	library
comentar	comment
completo	complete
diversion	diversion
imaginar	imagine
consulta	consult
amplificar	amplify
simplificar	simplify
celebrar	celebrate
divertir	divert
posible	possible
dependiente	dependable
curso	curse
motivado	motivated
diario	dairy
asociado	associated
costumbre	costume
convicto	convict
contestar	contest
confidente	confident
sensibilidad	sensibility
sistema	system
colegio	college
campo	camp
pacifico	pacific
bondad	bond
avalado	available
responsable	responsible
atender	attend
basico	basic
vehiculo	vehicle
red	red
letra	letter
antena	anthem
escolar	scholar
retirado	retired
novela	novel
medicina	medicine
lancha	lunch
neto	net
droga	drug
junco	junk
policia	policy
noticia	notice
pasta	pasta
maula	maul
dogma	dogma
prejuicio	prejudice
oficio	office
flanco	flank
trazar	trace
inhabitado	inhabitable
jornal	journal
exquisito	exquisite
puso	push
fila	fill
condimento	condiment
aumentar	augment
brinco	brink
copa	cup
proyecto	project
embarazada	embarrassed
preferencia	preference
dato	date
gafa	gaffe
gracioso	gracious
panel	panel
prioridad	priority
integral	integral
vital	vital
fatal	fatal
carton	card
vista	vista
escenario	scenario
